Abkhaz|ab|abk|abk|abks|
Afar|aa|aar|aar|aars|
Afrikaans|af|afr|afr|afrs|
Akan|ak|aka|aka||
Albanian|sq|alb|sqi||
Amharic|am|amh|amh||
Arabic|ar|ara|ara||
Aragonese|an|arg|arg||
Armenian|hy|arm|hye||
Assamese|as|asm|asm||
Avaric|av|ava|ava||
Avestan|ae|ave|ave||
Aymara|ay|aym|aym||
Azerbaijani|az|aze|aze||
Bambara|bm|bam|bam||
Bashkir|ba|bak|bak||
Basque|eu|baq|eus||
Belarusian|be|bel|bel||
Bengali, Bangla|bn|ben|ben||
Bihari|bh|bih|bih||
Bislama|bi|bis|bis||
Bosnian|bs|bos|bos|boss|
Breton|br|bre|bre||
Bulgarian|bg|bul|bul|buls|
Burmese|my|bur|mya||
Catalan, Valencian|ca|cat|cat||
Chamorro|ch|cha|cha||
Chechen|ce|che|che||
Chichewa, Chewa, Nyanja|ny|nya|nya||
Chinese|zh|chi|zho||
Chuvash|cv|chv|chv||
Cornish|kw|cor|cor||
Corsican|co|cos|cos||
Cree|cr|cre|cre||
Croatian|hr|hrv|hrv||
Czech|cs|cze|ces||
Danish|da|dan|dan||
Divehi, Dhivehi, Maldivian,|dv|div|div||
Dutch|nl|dut|nld||
Dzongkha|dz|dzo|dzo||
English|en|eng|eng|engs|
Esperanto|eo|epo|epo||
Estonian|et|est|est||
Ewe|ee|ewe|ewe||
Faroese|fo|fao|fao||
Fijian|fj|fij|fij||
Finnish|fi|fin|fin||
French|fr|fre|fra|fras|
Fula, Fulah, Pulaar, Pular|ff|ful|ful||
Galician|gl|glg|glg||
Georgian|ka|geo|kat||
German|de|ger|deu|deus|
Greek, Modern|el|gre|ell|ells|
Guaraní|gn|grn|grn||
Gujarati|gu|guj|guj||
Haitian, Haitian Creole|ht|hat|hat||
Hausa|ha|hau|hau||
Hebrew (modern)|he|heb|heb||
Herero|hz|her|her||
Hindi|hi|hin|hin|hins|
Hiri Motu|ho|hmo|hmo||
Hungarian|hu|hun|hun||
Interlingua|ia|ina|ina||
Indonesian|id|ind|ind||
Interlingue|ie|ile|ile||
Irish|ga|gle|gle||
Igbo|ig|ibo|ibo||
Inupiaq|ik|ipk|ipk||
Ido|io|ido|ido|idos|
Icelandic|is|ice|isl||
Italian|it|ita|ita|itas|
Inuktitut|iu|iku|iku||
Japanese|ja|jpn|jpn||
Javanese|jv|jav|jav||
Kalaallisut, Greenlandic|kl|kal|kal||
Kannada|kn|kan|kan||
Kanuri|kr|kau|kau||
Kashmiri|ks|kas|kas||
Kazakh|kk|kaz|kaz||
Khmer|km|khm|khm||
Kikuyu, Gikuyu|ki|kik|kik||
Kinyarwanda|rw|kin|kin||
Kyrgyz|ky|kir|kir||
Komi|kv|kom|kom||
Kongo|kg|kon|kon||
Korean|ko|kor|kor||
Kurdish|ku|kur|kur||
Kwanyama, Kuanyama|kj|kua|kua||
Latin|la|lat|lat|lats|
Luxembourgish, Letzeburgesch|lb|ltz|ltz||
Ganda|lg|lug|lug||
Limburgish, Limburgan, Limburger|li|lim|lim||
Lingala|ln|lin|lin||
Lao|lo|lao|lao||
Lithuanian|lt|lit|lit||
Luba-Katanga|lu|lub|lub||
Latvian|lv|lav|lav||
Manx|gv|glv|glv||
Macedonian|mk|mac|mkd||
Malagasy|mg|mlg|mlg||
Malay|ms|may|msa||
Malayalam|ml|mal|mal||
Maltese|mt|mlt|mlt||
M?ori|mi|mao|mri||
Marathi (Mar??h?)|mr|mar|mar||
Marshallese|mh|mah|mah||
Mongolian|mn|mon|mon||
Nauru|na|nau|nau||
Navajo, Navaho|nv|nav|nav||
Norwegian Bokmål|nb|nob|nob||
North Ndebele|nd|nde|nde||
Nepali|ne|nep|nep||
Ndonga|ng|ndo|ndo||
Norwegian Nynorsk|nn|nno|nno||
Norwegian|no|nor|nor||
Nuosu|ii|iii|iii||
South Ndebele|nr|nbl|nbl||
Occitan|oc|oci|oci||
Ojibwe, Ojibwa|oj|oji|oji||
Old Church Slavonic, Church Slavic, Church Slavonic, Old Bulgarian, Old Slavonic|cu|chu|chu||
Oromo|om|orm|orm||
Oriya|or|ori|ori||
Ossetian, Ossetic|os|oss|oss||
Panjabi, Punjabi|pa|pan|pan||
P?li|pi|pli|pli||
Persian|fa|per|fas||
Polish|pl|pol|pol|pols|
Pashto, Pushto|ps|pus|pus||
Portuguese|pt|por|por||
Quechua|qu|que|que||
Romansh|rm|roh|roh||
Kirundi|rn|run|run||
Romanian, Moldavian(Romanian from Republic of Moldova)|ro|rum|ron||
Russian|ru|rus|rus||
Sanskrit (Sa?sk?ta)|sa|san|san||
Sardinian|sc|srd|srd||
Sindhi|sd|snd|snd||
Northern Sami|se|sme|sme||
Samoan|sm|smo|smo||
Sango|sg|sag|sag||
Serbian|sr|srp|srp||
Scottish Gaelic, Gaelic|gd|gla|gla||
Shona|sn|sna|sna||
Sinhala, Sinhalese|si|sin|sin||
Slovak|sk|slo|slk||
Slovene|sl|slv|slv||
Somali|so|som|som||
Southern Sotho|st|sot|sot||
Spanish, Castilian|es|spa|spa||
Sundanese|su|sun|sun||
Swahili|sw|swa|swa||
Swati|ss|ssw|ssw||
Swedish|sv|swe|swe||
Tamil|ta|tam|tam||
Telugu|te|tel|tel||
Tajik|tg|tgk|tgk||
Thai|th|tha|tha||
Tigrinya|ti|tir|tir||
Tibetan Standard, Tibetan, Central|bo|tib|bod||
Turkmen|tk|tuk|tuk||
Tagalog|tl|tgl|tgl||
Tswana|tn|tsn|tsn||
Tonga (Tonga Islands)|to|ton|ton||
Turkish|tr|tur|tur||
Tsonga|ts|tso|tso||
Tatar|tt|tat|tat||
Twi|tw|twi|twi||
Tahitian|ty|tah|tah||
Uighur, Uyghur|ug|uig|uig||
Ukrainian|uk|ukr|ukr||
Urdu|ur|urd|urd||
Uzbek|uz|uzb|uzb||
Venda|ve|ven|ven||
Vietnamese|vi|vie|vie||
Volapük|vo|vol|vol||
Walloon|wa|wln|wln||
Welsh|cy|wel|cym||
Wolof|wo|wol|wol||
Western Frisian|fy|fry|fry||
Xhosa|xh|xho|xho||
Yiddish|yi|yid|yid||
Yoruba|yo|yor|yor||
Zhuang, Chuang|za|zha|zha||
Zulu|zu|zul|zul||
||||
